33333333333333333333333333333333
30000000000000000000000000000003
30000000000000000000000000000003
30000000000000000000000000000003
30000000000000000000000000000003
30000000000000000000000000000003
30000000000000000000000000000003
30000000000000000000000000000003
30000000400000000000000000000003
30000000400000000000000000000003
33333333333333333333333333333333