33333333333333333333333333333333
00000000000000000000000000000000
00000000000000000000000000000000
00000000000000000000000000000000
00000000000000000000000000000000
00000006t70000000000000000000000
0000006ttt7000000000000000000000
0000008bbb9000000000000000000000
00000000400000000000000000000000
55555555455555555555555555555555
11111111111111111111111111111111
22222222222222222222222222222222
33333333333333333333333333333333