33333333333333333333333333333333
00000000000000000000000000000000
00000000000000000000000000000000
00000000000000000000000000000000
00000000000000000000000000000000
00000000000000000000000000000000
00000005550000000000000000000000
00000055555000000000000000000000
00000000400000000000000000000000
00000000400000000000000000000000
11111111111111111111111111111111
22222222222222222222222222222222
33333333333333333333333333333333