33333333333333333333333333333333
30000000000000000000000000000003
30000000000000000000000000000003
30000000000000000000000000000003
30000000000000000000000000000003
30000000000000000000000000000003
30000000000000000000000000000003
30000000000000000000000000000003
30000000400000000000000000000003
30000000400000000000000000000003
11111111111111111111111111111111
22222222222222222222222222222222
33333333333333333333333333333333