44444444444444444444444444444444
40000000000000000000000000000004
40000000000000000000000000000004
40000000000000000000000000000004
40000000000000000000000000000004
40000000000000000000000000000004
40000000000000000000000000000004
40000000000000000000000000000004
40000000400000000000000000000004
40000000400000000000000000000004
44444444444444444444444444444444