000000000000000000000000000000000000000000
000000000000000000000000000000000000000000
000000000000000000000000000000000000000000
000fs0000000000000000000000000000000000000
00fpps000000000006t70000000000000000000000
0fpppps0000000006ttt7000000000000000000000
04pppp40000000008bbb9000000000000000000000
04ppDp400000000000400000000000000000000000
04ppdp400000000000400000000000000000000000
111111111110000011111111111111111111111111
222222222220000022222222222222222222222222
333333333330000033333333333333333333333333
333333333330000033333333333333333333333333
333333333330000033333333333333333333333333
333333333330000033333333333333333333333333
333333333330000033333333333333333333333333
333333333330000033333333333333333333333333
333333333330000033333333333333333333333333
333333333330000033333333333333333333333333
333333333330000033333333333333333333333333
333333333330000033333333333333333333333333
333333333330000033333333333333333333333333
333333333330000033333333333333333333333333
333333333330000033333333333333333333333333
333333333330000033333333333333333333333333