000000000000000000000000000000000000000000
000000000000000000000000000000000000000000
000000000000000000000000000000000000000000
000000000000000000000000000000000000000000
000000000000000000000000000000000000000000
000000000000000000000000000000000000000000
000000000000000000000000000000000000000000
000000000000000000000000000000000000000000
000000000000000000000000000000000000000000
000000000000000000000000000000000000000000
000000000000000000000000000000000000000000
000000000000000000000000000000000000000000
000000000000000000000000000000000000000000
000000000000000000000000000000000000000000
000000000000000000000000000000000000000000
000000000000000000000000000000000000000000
000000000000000000000000000000000000000000
000000000000000000000000000000000000000000
000000000000000000000000000000000000000000
000000000000000000000000000000000000000000
000000000000000000000000000000000000000000
000000000000000000000000000000000000000000
000000000000000000000000000000000000000000
000000000000000000000000000000000000000000
000000000000000000000000000000000000000000
000000000000000000000000000000000000000003
000000000000000000000000000000000000000003
000000000000000000000000000000000000000003
000000000000000000000000000000000000000003
000000000000000000000000000000000000000003
000000000000000000000000000000000000000003
333333333330000033333333333333333333333333
333333333330000033333333333333333333333333
333333333330000033333333333333333333333333
333333333330000033333333333333333333333333
333333333330000033333333333333333333333333
333333333330000033333333333333333333333333
333333333330000033333333333333333333333333
333333333330000033333333333333333333333333
333333333330000033333333333333333333333333
333333333330000033333333333333333333333333
333333333330000033333333333333333333333333
333333333330000033333333333333333333333333
333333333330000033333333333333333333333333
333333333330000033333333333333333333333333
333333333330000033333333333333333333333333
333333333330000033333333333333333333333333
333333333330000033333333333333333333333333
333333333330000033333333333333333333333333
333333333330000033333333333333333333333333
333333333330000033333333333333333333333333
333333333330000033333333333333333333333333
333333330000000000333333333333333333333333
333333300000000000033333333333333333333333333333333333333333333333333333333333333333333333333333333333333333333333333333333333333333333333333333333333333333333333333333
333333000000000000000000000000000000000000000000000000000000000000000000000000000000000000000000000000000000000000000000000000000000000000000000000000000000000000003333
333333000000000000000000000000000000000000000000000000000000000000000000000000000000000000000000000000000000000000000000000000000000000000000000000000000000000000003333
3333330000000000000000000D0000000000000000000000000000000000000000000000000000000000000000000000000000000000000000000000000000000000000000000000000000000000000000003333
3333333000000000000000000d00q0000000000000000000000000000000000000000000000000000000000000000000000000000000000000000000000000000000000000000000000000000000000000003333
333333330000000000033333333333333333333333333333333333333333333333333333333333333333333333333333333333333333333333333333333333333333333333333333333333333333333333333333
333333333333333333333333333333333333333333333333333333333333333333333333333333333333333333333333333333333333333333333333333333333333333333333333333333333333333333333333
333333333333333333333333333333333333333333
333333333333333333333333333333333333333333
333333333333333333333333333333333333333333